#####################@#####################@
#....................@....................#@
#...____\............@....................#@
#......./............@....................#@
#....................@....................#@
#....................@....................#@
#....................@....................#@
#####################@#...................#@
