#.#..................@
#.#..................@
#.#..................@
#.###################@
#.................W.#@
#####################@
.....................@
.....................@