~~~~~~~/.............
~~~~~~~\.............
_______/.............
.....................
.....................
.....................
.....................
.....................